1111111111111
10CCCCCCC0E11
1P11111111111
1111111111111