11111111111111111111111111111
11111111100000000000000000011
110NNNNN011111111111111111001
1E0000P000CCCCCCCCCCCCCC00001
11111111111111111111111111111