1111111111111111111
10P00CCCCCCCCCC0E01
1111111111111111111