1111111111111
10CCCCCCC0E01
1P11111110101
1101011110101
1100000110101
1101010110101
1101101010101
1101000010101
1101011010101
1100011000101
1111111111111