1111111111111
10CCCCCCC0E01
1P11111110111
1101011110101
1100000110101
1101010110101
1101101010101
1101000010101
1101011010111
1100011000111
1111111111111