11111111111111111111111111111111111111
11111111111111111111111111111111111111
11100000000111111111111111111000000011
10111111100100000000000000010111111001
10100001100000000010000000000000100001
11100000110111111111111111111111100001
11101000010111111111111111111111001001
11100111110111110000000000000011111001
11100100010000000111111111110000000101
11111111111111111000000000111111111111
10000000000000000P00NN00000C00000000E1
11111111111111111111111111111111111111
