11111111111111111111111111111111111111
11111111111111111111111111111111111111
11100000000111111111111111111000000011
10111111100C000000000000000C0111111001
10C0000111111111110111111111110000C001
10C0000000000111100C000000000000000001
10111111111111111000111111111111111001
10C000011000000000C0000000000000C00001
11100000110111111111111111111111100001
1110C0000C011111111111111111111100C001
11100111110111110000000000000011111001
11100C000C0000000C11111111110000000C01
11111111111111111000000000111111111111
1P0000000000000000000000000C00000000E1
11111111111111111111111111111111111111