1111111111111111111111111111111111111111
1111100000000111111111111111111000000011
1000111111100C000000000000000C0111111001
1000C0000111111111110111111111110000C001
1000C0000000000111100C000000000000000001
1000111111111111111000111111111111111001
1000C000011000000000C0000000000000C00001
1111100000110111111111111111111111100001
111110C0000C011111111111111111111100C001
1111100111110111110000000000000011111001
1111100C000C0000000C11111111110000000C01
1111111111111111111000000000111111111111
1P000000000000000000000000000C00000000E1
1111111111111111111111111111111111111111