11111111111111111111111111111
101000C00000000000C0000C00001
101CC1110101010C1111111111111
100001N10000C000000CN100C1N11
1CCCCCCCCCCCCCCCCCCCCCCCCCCC1
1CCCCCCCCCCCCCCCCCCCCCCCCCCC1
1CCCCCCCCCCCCCCCCCCCCCCCCCCC1
11100111010101000000000000001
100CCCCCCCCCCCCCCCCCCCCCCCCC1
11C1C1C1C1C1C1000101C1P1N1E11
1CCCCCCCCCCCCCCCCCCCCCCCCCCC1
1CCCCCCCCCCCCCCCCCCCCCCCCCCC1
11111111111111111111111111111