111111111111111111
1E000CCCCCCCCP0001
111111111111111111