11111111111111111111111111111
1C1000C00000000000C0000C00001
101CC1110101010C1111111111111
100001N10000C000000CN100C1N11
11100111010101000000000000001
10000000P000000010101N10101C1
11C1C1C1C1C1C1000101C101N1E11
10N000N000N0N0000000000000001
10000000000000010101001011101
11111111111111111111111111111