111111111111111111
1CE0000CCCCCC000P1
100000N00000000001
100000000000000001
111111111111111111
