111111111111111111
1E000CCCCCCCCP00N1
111111111111111111